NO ./textures_imgs/north.xpm
SO ./textures_imgs/south.xpm
WE ./textures_imgs/west.xpm
EA ./textures_imgs/east.xpm
F 220,abc,0
C 225,30,0

1111111111111
1000000000001
1000N00000001
1000000000001
1111111111111
